      ###############################      
   ###                               ###   
  #                                     #  
 #                                       # 
 #                                       # 
#                                         #
#                                         #
#                                         #
#             s              s            #
#                                         #
#                                         #
#                                         #
#                                         #
#                                         #
#                                         #
#                                         #
#                                         #
#                       @                  #
#                                         #
#                                         #
#                                         #
#                                         #
#                                         #
###########################################